2 2 2 2 3 1 2 2 2 2 2 2 1 1 2 
2 2 2 2 1 1 3 2 2 2 3 3 1 1 1 
2 2 3 2 1 1 2 2 2 1 1 1 1 1 4 
2 2 2 2 1 1 3 3 2 2 1 4 1 2 4 
2 3 2 1 1 1 2 3 2 2 1 1 1 2 4 
2 2 2 1 1 1 2 2 2 2 3 3 1 1 4 
2 2 2 2 2 2 2 2 2 2 2 2 2 1 6 
2 3 3 2 1 1 2 2 2 2 1 2 1 1 3 
2 3 2 2 1 1 2 3 2 2 2 4 2 3 3 
5 2 1 1 1 1 1 2 3 2 2 2 1 3 2 
# Pieces
14 9 BLUE BASE 150
1 1 RED BASE 150
14 4 BLUE GENERATOR 100
14 3 BLUE GENERATOR 100
14 5 BLUE GENERATOR 100
14 2 BLUE GENERATOR 100
13 9 BLUE COLONIST 100
# Teams
RED 3
BLUE 3
# Upgrades
RED|
BLUE|COLONIST_TERRAFORMING 
# Meta
Turn 1 
Phase ORDERS 
