2 4 4 2 3 2 2 2 2 2 2 2 1 1 5 
2 2 2 2 2 2 3 2 2 4 3 3 1 1 1 
2 2 3 4 1 2 2 2 2 1 1 1 1 1 2 
2 2 2 2 1 1 3 3 2 4 1 2 1 2 3 
2 3 2 1 1 1 4 3 2 2 1 1 1 2 2 
2 4 2 1 1 2 2 2 2 4 3 3 1 1 2 
2 2 4 2 2 1 4 2 2 4 2 2 2 1 6 
2 3 3 2 2 2 2 2 2 2 1 2 2 2 2 
2 3 2 2 1 1 2 3 2 4 2 3 2 3 1 
5 4 1 1 1 1 1 2 3 4 2 2 1 1 2 
# Pieces
2 3 RED BASE 150
14 9 BLUE BASE 150
2 6 BLUE GENERATOR 100
13 4 RED BOLTCASTER 60
14 5 RED GUARDIAN 80
2 5 RED COLONIST 100
1 2 RED BARRACKS 100
7 5 RED TROOPER 100
7 5 BLUE TROOPER 100
8 4 NONE TROOPER 100
# Teams
RED 3
BLUE 3
# Upgrades
RED|
BLUE|
# Meta
Turn 1 
Phase ORDERS 
