4 4 4 2 3 2 2 2 2 2 2 2 1 1 5 
2 2 2 2 2 2 3 2 2 4 3 3 1 1 1 
2 2 3 4 1 2 2 2 2 2 2 1 1 1 2 
2 2 2 2 1 1 3 3 2 4 1 1 1 2 3 
2 3 2 1 1 1 4 3 2 2 1 1 1 2 2 
2 4 2 1 1 2 2 2 2 4 3 3 1 1 2 
2 2 4 2 2 1 4 2 2 4 2 2 2 1 1 
2 3 3 2 2 2 2 2 2 2 1 2 2 2 2 
2 3 2 2 1 1 2 3 2 4 2 3 2 3 1 
5 4 1 1 1 1 1 2 3 4 2 2 1 2 2 
# Pieces
2 3 RED BASE 150
8 1 RED RANGER 90
6 1 RED GHOST 80
14 9 BLUE BASE 150
7 9 BLUE BARRACKS 100
9 9 BLUE GENERATOR 100
9 8 BLUE GENERATOR 100
7 2 RED TROOPER 100
7 6 BLUE TROOPER 100
8 6 BLUE TROOPER 100
7 7 BLUE RANGER 90
# Teams
RED 3
BLUE 3
# Upgrades
RED|
BLUE|
# Meta
Turn 1 
Phase ORDERS 
