1 1 1 1 1 1 6 4 6 1 1 1 1 1 1 
1 1 1 1 1 1 4 3 4 1 1 1 1 1 1 
1 1 1 1 1 6 4 2 4 6 1 1 1 1 1 
1 1 1 1 1 4 3 2 3 4 1 1 1 1 1 
1 1 1 6 5 7 4 3 4 7 5 6 1 1 1 
1 1 6 3 7 5 7 3 7 5 7 3 6 1 1 
1 1 6 3 2 7 1 1 1 7 2 3 6 1 1 
1 1 5 7 2 3 2 6 2 3 2 7 5 1 1 
1 6 2 2 2 3 3 6 3 3 2 2 2 6 1 
1 3 2 2 7 5 6 1 6 5 7 2 2 3 1 
1 7 3 2 2 1 1 1 1 1 2 2 3 7 1 
1 7 2 2 2 1 1 1 1 1 2 2 2 7 1 
1 6 4 2 4 1 1 1 1 1 4 2 4 6 1 
1 1 3 4 3 1 1 1 1 1 3 4 3 1 1 
1 1 1 1 1 1 1 1 1 1 1 1 1 1 1 
# Pieces
3 11 RED BASE 150
11 11 BLUE BASE 150
11 13 BLUE GENERATOR 100
3 13 RED GENERATOR 100
4 10 RED BARRACKS 100
10 10 BLUE BARRACKS 100
3 12 RED COLONIST 100
11 12 BLUE COLONIST 100
# Teams
RED 5
BLUE 5
# Upgrades
RED|COLONIST_TERRAFORMING 
BLUE|COLONIST_TERRAFORMING 
# Meta
Turn 1 
Phase ORDERS 
