5 7 5 5 5 2 2 2 3 4 2 2 7 5 5 3 3 7 5 5 
5 5 5 7 4 3 2 2 5 7 2 2 3 7 3 4 2 3 4 5 
5 5 4 3 2 2 2 2 3 5 2 2 2 2 2 2 2 2 2 4 
5 7 3 2 2 4 3 2 2 5 3 2 2 2 2 2 2 2 4 3 
5 7 2 2 4 3 5 2 2 3 2 2 2 2 2 2 2 2 3 7 
5 2 2 2 3 5 5 1 6 6 6 4 2 2 5 7 3 3 5 5 
7 2 2 2 2 1 1 1 1 1 1 1 4 2 7 5 5 7 5 5 
3 4 2 2 2 1 1 1 1 1 1 1 6 2 2 2 2 3 7 7 
7 7 3 2 2 2 2 6 1 1 1 1 1 1 1 2 2 2 4 3 
5 5 7 5 5 7 2 4 1 1 1 1 1 1 1 2 2 2 2 7 
5 5 3 3 7 5 2 2 4 6 6 6 1 5 5 3 2 2 2 5 
7 3 2 2 2 2 2 2 2 2 3 2 2 5 3 4 2 2 7 5 
3 4 2 2 2 2 2 2 2 3 5 2 2 3 4 2 2 3 7 5 
4 2 2 2 2 2 2 2 2 2 5 3 2 2 2 2 3 4 5 5 
5 4 3 2 4 3 7 3 2 2 7 5 2 2 3 4 7 5 5 5 
5 5 7 3 3 5 5 7 2 2 4 3 2 2 2 5 5 5 7 5 
# Pieces
3 12 RED BASE 150
16 3 BLUE BASE 150
5 13 RED BARRACKS 100
14 2 BLUE BARRACKS 100
1 13 RED COLONIST 100
18 2 BLUE COLONIST 100
4 14 RED GENERATOR 100
15 1 BLUE GENERATOR 100
# Teams
RED 6
BLUE 6
# Upgrades
RED|
BLUE|
# Meta
Turn 1
Phase START_TURN
