1 1 1 1 1 1 1 1 1 1 1 1 1 1 1 1 1 1 1 1 
1 1 1 1 1 1 1 1 1 1 1 1 1 1 1 1 1 1 1 1 
1 1 5 4 4 7 6 1 1 1 1 1 1 1 1 1 1 1 1 1 
1 1 4 3 2 2 2 6 1 1 1 1 1 1 1 1 1 1 1 1 
1 1 4 2 2 2 2 2 6 1 2 6 6 4 4 1 1 1 1 1 
1 1 1 7 2 2 2 3 1 1 1 1 1 2 2 6 1 1 1 1 
1 1 1 2 2 4 3 3 3 5 6 6 7 3 2 6 1 1 1 1 
1 1 1 6 1 5 7 3 3 4 2 2 2 2 2 6 1 2 1 1 
1 1 1 1 1 1 1 4 3 2 2 2 3 4 1 1 1 1 1 1 
1 1 1 2 1 6 2 2 2 2 2 4 3 3 7 5 1 6 1 1 
1 1 1 1 1 6 2 3 7 6 6 5 3 3 3 4 2 2 1 1 
1 1 1 1 1 6 2 2 1 1 1 1 1 3 2 2 2 7 1 1 
1 1 1 1 1 1 4 4 6 6 2 1 6 2 2 2 2 2 4 1 
1 1 1 1 1 1 1 1 1 1 1 1 1 6 2 2 2 3 4 1 
1 1 1 1 1 1 1 1 1 1 1 1 1 1 6 7 4 4 5 1 
1 1 1 1 1 1 1 1 1 1 1 1 1 1 1 1 1 1 1 1 
# Pieces
4 4 RED BASE 150
16 12 BLUE BASE 150
3 3 RED COLONIST 100
17 13 BLUE COLONIST 100
5 3 RED BARRACKS 100
15 13 BLUE BARRACKS 100
# Teams
RED 5
BLUE 5
# Upgrades
RED|
BLUE|
