1 1 1 1 1 1 1 1 1 1 1 1 1 1 1 
1 1 4 2 4 5 1 1 1 1 1 1 1 1 1 
1 4 3 2 2 3 5 1 1 3 2 4 1 1 1 
1 2 3 2 2 3 2 2 2 2 3 2 4 1 1 
1 4 2 2 2 2 2 2 2 2 2 2 5 1 1 
1 1 2 2 3 3 5 1 1 4 2 2 3 1 1 
1 1 1 2 3 5 1 1 1 5 2 3 1 1 1 
1 1 1 3 2 5 1 1 1 5 3 2 1 1 1 
1 1 3 2 2 4 1 1 5 3 3 2 2 1 1 
1 1 5 2 2 2 2 2 2 2 2 2 2 4 1 
1 1 4 2 3 2 2 2 2 3 2 2 3 2 1 
1 1 1 4 2 3 1 1 5 3 2 2 3 4 1 
1 1 1 1 1 1 1 1 1 5 4 2 4 1 1 
1 1 1 1 1 1 1 1 1 1 1 1 1 1 1
# Pieces
3 3 RED BASE 100
4 4 RED BARRACKS 100
11 10 BLUE BASE 100
10 9 BLUE BARRACKS 100
# Teams
RED 5 5 5
BLUE 5 5 5
# Upgrades
RED|
BLUE|
