1 1 6 6 6 1 1 1 1 1 1 1 1 1 1 
1 6 4 2 4 5 1 1 1 1 1 1 1 1 1 
1 4 3 2 2 7 5 6 6 3 7 4 1 1 1 
1 2 3 2 2 3 2 2 2 2 3 2 4 1 1 
1 4 2 2 2 2 2 2 2 2 2 2 5 1 1 
1 1 6 2 3 3 5 1 1 4 2 2 3 1 1 
1 1 1 2 3 5 6 1 6 5 2 3 1 1 1 
1 1 1 3 2 5 6 1 6 5 3 2 1 1 1 
1 1 3 2 2 4 1 1 5 3 3 2 6 1 1 
1 1 5 2 2 2 2 2 2 2 2 2 2 4 1 
1 1 4 2 3 2 2 2 2 3 2 2 3 2 1 
1 1 1 4 7 3 6 6 5 7 2 2 3 4 1 
1 1 1 1 1 1 1 1 1 5 4 2 4 6 1 
1 1 1 1 1 1 1 1 1 1 6 6 6 1 1 
# Pieces
3 3 RED BASE 150
4 4 RED BARRACKS 100
11 10 BLUE BASE 150
10 9 BLUE BARRACKS 100
# Teams
RED 5
BLUE 5
# Upgrades
RED|
BLUE|
# Meta
Turn 1 
Phase ORDERS 
