5 5 7 5 5 5 1 5 5 7 3 4 5 4 5 
5 5 5 7 3 2 1 5 2 3 2 3 2 3 4 
7 5 3 4 3 3 1 1 3 3 5 2 2 2 3 
5 3 4 3 3 3 2 6 2 3 3 5 2 3 3 
7 3 2 2 3 2 2 6 2 2 3 7 3 3 2 
2 3 3 7 3 2 2 6 2 2 3 2 2 3 7 
3 3 2 5 3 3 2 6 2 3 3 3 4 3 5 
3 2 2 2 5 3 3 1 1 3 3 4 3 5 7 
4 3 2 3 2 3 2 5 1 2 3 7 5 5 5 
5 4 5 4 3 7 5 5 1 5 5 5 7 5 5 
# Pieces
12 1 RED BASE 150
2 8 BLUE BASE 150
11 0 RED GENERATOR 100
3 9 BLUE GENERATOR 100
1 8 BLUE COLONIST 100
13 1 RED COLONIST 100
# Teams
RED 5
BLUE 5
# Upgrades
RED|
BLUE|
# Meta
Turn 1 
Phase ORDERS 
