4 2 4 7 7 4 3 7 7 1 7 7 5 7 5 7 5 5 5 5 
2 2 2 3 7 2 4 7 3 1 7 3 4 7 7 7 7 7 5 5 
2 3 2 3 7 7 7 7 2 1 7 4 3 7 3 2 3 7 7 7 
6 6 1 1 1 1 7 3 3 1 1 6 6 1 1 2 2 7 4 7 
3 2 7 2 3 1 7 2 2 3 2 2 3 7 1 2 2 7 3 4 
4 3 7 2 2 1 7 3 2 2 3 2 2 7 1 3 2 7 2 3 
7 4 7 2 2 1 1 6 6 1 1 3 3 7 1 1 1 1 6 6 
7 7 7 3 2 3 7 3 4 7 1 2 7 7 7 7 3 2 3 2 
5 5 7 7 7 7 7 4 3 7 1 3 7 4 2 7 3 2 2 2 
5 5 5 5 7 5 7 5 7 7 1 7 7 3 4 7 7 4 2 4 
# Pieces
0 2 RED BASE 150
19 7 BLUE BASE 150
17 9 BLUE GENERATOR 100
19 9 BLUE GENERATOR 100
0 0 RED GENERATOR 100
2 0 RED GENERATOR 100
1 1 RED BARRACKS 100
18 8 BLUE BARRACKS 100
# Teams
RED 5
BLUE 5
# Upgrades
RED|
BLUE|
# Meta
Turn 1 
Phase START_TURN
