5 4 7 1 5 7 1 4 1 4 2 4 1 4 4 
2 2 4 1 3 3 6 3 6 2 2 2 1 1 1 
6 1 1 1 3 2 1 1 1 3 2 3 6 3 5 
3 1 7 3 2 2 3 7 1 1 1 1 1 2 7 
6 1 2 2 2 2 2 3 3 7 4 4 3 2 3 
3 2 3 4 4 7 3 3 2 2 2 2 2 1 6 
7 2 1 1 1 1 1 7 3 2 2 3 7 1 3 
5 3 6 3 2 3 1 1 1 2 3 1 1 1 6 
1 1 1 2 2 2 6 3 6 3 3 1 4 2 2 
4 4 1 4 2 4 1 4 1 7 5 1 7 4 5 
# Pieces
4 8 RED BASE 150
10 1 BLUE BASE 150
9 0 BLUE GENERATOR 100
11 0 BLUE GENERATOR 100
5 9 RED GENERATOR 100
3 9 RED GENERATOR 100
4 7 RED BARRACKS 100
10 2 BLUE BARRACKS 100
# Teams
RED 5
BLUE 5
# Upgrades
RED|
BLUE|
# Meta
Turn 1 
Phase START_TURN
