5 5 7 7 5 5 5 5 5 5 5 5 5 5 5 5 7 7 5 5 
5 7 4 4 7 5 5 5 7 4 4 7 5 5 5 7 4 4 7 5 
7 2 2 2 4 5 5 7 4 2 2 4 7 5 5 4 2 2 2 7 
3 2 2 2 2 7 5 5 4 2 2 4 5 5 7 2 2 2 2 3 
2 2 2 2 3 3 5 5 7 4 4 7 5 5 3 3 2 2 2 2 
7 2 3 2 2 4 7 5 5 7 7 5 5 7 4 2 2 3 2 7 
5 3 3 3 2 2 4 5 5 7 7 5 5 4 2 2 3 3 3 5 
5 5 7 3 3 2 2 3 7 3 3 7 3 2 2 3 3 7 5 5 
5 5 5 5 7 2 2 2 3 3 3 3 2 2 2 7 5 5 5 5 
5 7 5 5 5 5 7 3 2 3 3 2 3 7 5 5 5 5 7 5 
# Pieces
1 2 BLUE BASE 150
18 2 RED BASE 150
17 3 RED BARRACKS 100
2 3 BLUE BARRACKS 100
3 2 BLUE COLONIST 100
16 2 RED COLONIST 100
17 1 RED GENERATOR 100
2 1 BLUE GENERATOR 100
# Teams
RED 5
BLUE 5
# Upgrades
RED|
BLUE|
# Meta
Turn 1 
Phase ORDERS 
