5 5 5 7 7 5 3 4 7 7 7 7 4 3 5 7 7 5 5 5 
5 5 7 4 2 7 7 3 4 7 7 4 3 7 7 2 4 7 5 5 
5 7 4 2 3 2 5 7 3 3 3 3 7 5 2 3 2 4 7 5 
5 7 2 2 3 2 7 5 7 3 3 7 5 7 2 3 2 2 7 5 
5 7 2 3 2 2 2 7 5 2 2 5 7 2 2 2 3 2 7 5 
6 5 7 2 2 2 2 2 3 2 2 3 2 2 2 2 2 7 5 6 
6 5 7 4 2 2 2 2 3 7 7 3 2 2 2 2 4 7 5 6 
1 6 5 7 4 2 3 7 7 5 5 7 7 3 2 4 7 5 6 1 
7 1 5 5 7 7 7 5 5 5 5 5 5 7 7 7 5 5 1 7 
5 1 7 5 5 7 5 5 4 4 4 4 5 5 7 5 5 7 1 5 
# Pieces
5 7 RED BASE 150
14 7 BLUE BASE 150
15 7 BLUE GENERATOR 100
16 6 BLUE GENERATOR 100
3 6 RED GENERATOR 100
4 7 RED GENERATOR 100
4 6 RED COLONIST 100
15 6 BLUE COLONIST 100
# Teams
RED 5
BLUE 5
# Upgrades
RED|
BLUE|
# Meta
Turn 1 
Phase ORDERS 
