1 1 1 1 1 1 1 1 1 1 1 1 1 1 1
1 1 1 6 4 2 5 5 2 4 6 1 1 1 1
1 1 1 4 2 3 5 5 3 2 4 1 1 1 1
1 1 1 2 2 3 5 5 3 2 2 1 1 1 1
1 1 1 6 2 2 7 7 2 2 6 1 1 1 1
1 1 1 3 4 2 2 2 2 4 3 1 1 1 1
1 1 6 2 1 4 3 3 4 1 2 6 1 1 1
1 1 1 6 1 1 6 6 1 1 6 1 1 1 1
1 1 1 1 1 1 1 1 1 1 1 1 1 1 1
1 1 1 1 1 1 1 1 1 1 1 1 1 1 1
# Pieces
5 1 RED BASE 150
8 1 BLUE BASE 150
4 1 RED GENERATOR 100
3 2 RED GENERATOR 100
9 1 BLUE GENERATOR 100
10 2 BLUE GENERATOR 100
10 6 BLUE BARRACKS 100
3 6 RED BARRACKS 100
# Teams
RED 5
BLUE 5
# Upgrades
RED|
BLUE|
# Meta
Turn 1 
Phase START_TURN
