5 5 6 7 7 4 1 2 7 7 7 7 2 3 4 4 4 6 6 1 
5 7 6 4 2 6 1 2 4 7 4 3 3 7 2 2 2 2 3 1 
7 4 1 1 1 1 7 2 3 4 2 2 2 7 2 3 2 2 3 1 
4 6 1 7 7 3 2 2 2 3 2 2 2 3 4 3 3 2 3 1 
1 1 3 5 2 4 7 7 2 2 2 2 2 7 7 4 2 2 6 1 
1 3 7 5 4 2 7 5 2 2 2 4 2 2 7 2 2 2 6 1 
1 7 5 7 2 2 3 5 7 7 7 2 4 2 3 3 2 5 3 1 
1 7 5 3 2 2 2 3 7 5 5 7 3 2 2 2 3 5 7 1 
1 3 5 2 3 3 2 4 2 7 7 7 5 3 2 2 7 5 7 1 
1 6 2 2 2 7 2 2 4 2 2 2 5 7 2 4 5 7 3 1 
1 6 2 2 4 7 7 2 2 2 2 2 7 7 4 2 5 3 1 1 
1 3 2 3 3 4 3 2 2 2 3 2 2 2 3 7 7 1 6 4 
1 3 2 2 3 2 7 2 2 2 4 3 2 7 1 1 1 1 4 7 
1 3 2 2 2 2 7 3 3 4 7 4 2 1 6 2 4 6 7 5 
1 6 6 4 4 4 3 2 7 7 7 7 2 1 4 7 7 6 5 5 
# Pieces
2 12 RED BASE 150
17 2 BLUE BASE 150
5 14 RED GENERATOR 100
4 14 RED GENERATOR 100
3 14 RED GENERATOR 100
16 0 BLUE GENERATOR 100
15 0 BLUE GENERATOR 100
14 0 BLUE GENERATOR 100
15 1 BLUE BARRACKS 100
4 13 RED BARRACKS 100
4 11 RED COLONIST 100
15 3 BLUE COLONIST 100
# Teams
RED 5
BLUE 5
# Upgrades
RED|
BLUE|
# Meta
Turn 1 
Phase START_TURN
