1 1 1 1 1 1 1 1 1 1 3 4 2 3 3 2 4 1 1 1 
1 1 1 1 3 4 2 2 4 3 4 2 2 2 2 2 2 2 1 1 
1 1 3 4 2 2 2 2 3 4 3 2 2 2 1 1 3 2 4 1 
1 4 2 2 2 2 2 2 2 2 2 2 2 3 1 1 1 2 2 1 
1 2 2 2 2 2 2 2 2 2 2 3 3 2 3 1 1 2 2 1 
1 1 3 2 2 2 3 2 1 1 1 4 2 3 3 2 4 2 2 1 
1 1 1 2 1 2 1 1 1 1 1 1 1 3 2 2 2 3 1 1 
1 1 3 2 2 2 3 1 1 1 1 1 1 1 2 1 2 1 1 1 
1 2 2 4 2 3 3 2 4 1 1 1 1 3 2 2 2 3 1 1 
1 2 2 1 1 3 2 3 3 2 2 2 2 2 2 2 2 2 2 1 
1 2 2 1 1 1 3 2 2 2 2 2 2 2 2 2 2 2 4 1 
1 4 2 3 1 1 2 2 2 3 4 3 2 2 2 2 4 3 1 1 
1 1 2 2 2 2 2 2 2 4 3 4 2 2 4 3 1 1 1 1 
1 1 1 4 2 3 3 2 4 3 1 1 1 1 1 1 1 1 1 1
# Pieces
5 3 RED BASE
4 4 RED BARRACKS
5 1 RED GENERATOR
3 2 RED GENERATOR
1 3 RED GENERATOR
14 10 BLUE BASE
15 9 BLUE BARRACKS
14 12 BLUE GENERATOR
16 11 BLUE GENERATOR
18 10 BLUE GENERATOR
# Teams
RED 6
BLUE 6
# Upgrades
RED|
BLUE|