1 1 1 1 1 1 1 1 1 7 7 4 5 7 7 2 4 6 1 1 
1 1 5 5 3 4 5 5 4 7 4 2 2 2 2 2 2 2 6 1 
1 5 3 4 2 2 2 2 3 4 2 2 2 2 1 6 3 2 4 1 
1 4 2 2 2 2 2 2 2 2 2 2 2 3 1 1 6 2 2 1 
1 7 2 2 2 2 2 2 6 6 2 3 3 2 3 1 1 2 2 1 
1 1 3 2 2 2 3 6 1 1 1 4 2 3 3 2 4 2 6 1 
1 1 1 2 1 2 1 1 1 1 1 6 6 3 2 2 2 3 1 1 
1 1 3 2 2 2 3 6 6 1 1 1 1 1 2 1 2 1 1 1 
1 6 2 4 2 3 3 2 4 1 1 1 6 3 2 2 2 3 1 1 
1 2 2 1 1 3 2 3 3 2 6 6 2 2 2 2 2 2 7 1 
1 2 2 6 1 1 3 2 2 2 2 2 2 2 2 2 2 2 4 1 
1 4 2 3 6 1 2 2 2 3 4 3 2 2 2 2 4 3 5 1 
1 6 2 2 2 2 2 2 2 4 7 4 5 5 4 3 5 5 1 1 
1 1 6 4 2 7 7 5 4 7 7 1 1 1 1 1 1 1 1 1 
# Pieces
5 3 RED BASE 150
4 4 RED BARRACKS 100
5 1 RED GENERATOR 100
3 2 RED GENERATOR 100
1 3 RED GENERATOR 100
14 10 BLUE BASE 150
15 9 BLUE BARRACKS 100
14 12 BLUE GENERATOR 100
16 11 BLUE GENERATOR 100
18 10 BLUE GENERATOR 100
# Teams
RED 6
BLUE 6
# Upgrades
RED|
BLUE|
# Meta
Turn 1 
Phase ORDERS 
