1 1 1 1 1 1 1 1 1 1 3 4 2 3 3 2 4 1 1 1 
1 1 1 1 3 4 2 2 4 3 4 2 2 2 2 2 2 2 1 1 
1 1 3 4 2 2 2 2 3 4 3 2 2 2 1 1 3 2 4 1 
1 4 2 2 2 2 2 2 2 2 2 2 2 3 1 1 1 2 2 1 
1 2 2 2 2 2 2 2 2 2 2 3 3 2 3 1 1 2 2 1 
1 1 3 2 2 2 3 2 1 1 1 4 2 3 3 2 4 2 2 1 
1 1 1 2 1 2 1 1 1 1 1 1 1 3 2 2 2 3 1 1 
1 1 3 2 2 2 3 1 1 1 1 1 1 1 2 1 2 1 1 1 
1 2 2 4 2 3 3 2 4 1 1 1 1 3 2 2 2 3 1 1 
1 2 2 1 1 3 2 3 3 2 2 2 2 2 2 2 2 2 2 1 
1 2 2 1 1 1 3 2 2 2 2 2 2 2 2 2 2 2 4 1 
1 4 2 3 1 1 2 2 2 3 4 3 2 2 2 2 4 3 1 1 
1 1 2 2 2 2 2 2 2 4 3 4 2 2 4 3 1 1 1 1 
1 1 1 4 2 3 3 2 4 3 1 1 1 1 1 1 1 1 1 1
# Pieces
5 3 RED BASE
4 4 RED BARRACKS
5 1 RED CARBON_GENERATOR
3 2 RED MINERAL_GENERATOR
1 3 RED GAS_GENERATOR
14 10 BLUE BASE
15 9 BLUE BARRACKS
14 12 BLUE CARBON_GENERATOR
16 11 BLUE MINERAL_GENERATOR
18 10 BLUE GAS_GENERATOR
# Teams
RED 6 6 6
BLUE 6 6 6
# Upgrades
RED|
BLUE|