1 1 1 1 1 2 1 1 1 1 2 2 2 2 2 3 2 2 2 3 
1 1 1 1 1 2 2 2 2 1 1 2 2 3 2 2 4 2 2 2 
1 1 1 1 1 2 2 2 4 2 2 2 2 2 7 4 2 3 2 1 
1 1 1 1 1 2 4 2 2 2 2 3 7 5 5 7 7 2 3 1 
1 1 1 1 1 1 3 2 4 2 2 7 7 5 5 5 2 2 2 1 
1 1 1 1 1 1 2 2 2 2 2 7 5 5 5 7 2 2 1 1 
1 1 1 1 1 1 1 2 2 2 3 7 5 5 5 7 2 2 4 1 
1 1 1 1 1 1 1 1 4 2 2 7 5 7 7 2 2 2 2 2 
1 1 1 1 1 1 1 1 2 2 2 2 7 7 3 2 2 3 2 1 
1 1 1 1 1 1 1 1 2 2 2 2 2 2 2 2 2 2 2 2 
1 1 1 1 1 1 1 1 2 2 2 3 2 2 2 2 4 2 2 4 
1 1 1 1 1 1 1 1 1 1 2 2 2 2 2 2 2 2 2 1 
1 1 1 1 1 1 1 1 1 1 1 4 4 2 2 2 2 2 2 1 
1 1 1 1 1 1 1 1 1 1 1 1 1 1 2 2 2 2 4 1 
1 1 1 1 1 1 1 1 1 1 1 1 1 1 1 1 1 1 1 1 
# Pieces
# Teams
RED 5
BLUE 5
# Upgrades
RED|
BLUE|
# Meta
Turn 1 
Phase ORDERS 
