7 5 5 2 2 3 6 2 2 2 5 5 2 4 5 
7 4 3 2 2 2 6 4 3 2 3 2 2 2 4 
2 3 2 2 2 1 1 1 1 2 2 2 2 3 3 
2 2 2 2 1 1 1 1 1 6 3 2 2 3 5 
5 3 2 2 6 1 1 1 1 6 4 2 2 7 5 
5 7 2 2 4 6 1 1 1 1 6 2 2 3 5 
5 3 2 2 3 6 1 1 1 1 1 2 2 2 2 
3 3 2 2 2 2 1 1 1 1 2 2 2 3 2 
4 2 2 2 3 2 3 4 6 2 2 2 3 4 7 
5 4 2 5 5 2 2 2 6 3 2 2 5 5 7 
# Pieces
3 6 RED BASE 150
11 3 BLUE BASE 150
10 4 BLUE GENERATOR 100
4 5 RED GENERATOR 100
2 7 RED COLONIST 100
12 2 BLUE COLONIST 100
# Teams
RED 5
BLUE 5
# Upgrades
RED|
BLUE|
# Meta
Turn 1 
Phase ORDERS 
