1 1 1 7 7 5 7 2 2 1 1 1 1 7 3 
1 1 6 2 4 7 4 2 2 2 7 3 2 2 2 
1 6 2 3 3 4 3 2 2 2 2 2 2 2 4 
1 6 7 2 3 3 2 2 2 2 2 2 4 5 5 
6 3 7 2 2 2 2 2 2 2 3 7 5 5 5 
6 3 2 2 2 2 2 2 7 5 3 3 5 5 4 
7 2 2 2 2 2 2 4 5 5 3 3 5 4 2 
5 2 2 2 2 4 5 5 5 5 7 3 2 2 3 
7 2 2 2 4 5 5 5 7 5 5 2 2 2 7 
3 2 2 7 5 5 5 5 5 5 5 7 2 2 7 
7 2 2 7 5 5 5 5 5 5 5 7 2 2 3 
7 2 2 2 5 5 7 5 5 5 4 2 2 2 7 
3 2 2 3 7 5 5 5 5 4 2 2 2 2 5 
2 4 5 3 3 5 5 4 2 2 2 2 2 2 7 
4 5 5 3 3 5 7 2 2 2 2 2 2 3 6 
5 5 5 7 3 2 2 2 2 2 2 2 7 3 6 
5 5 4 2 2 2 2 2 2 3 3 2 7 6 1 
4 2 2 2 2 2 2 2 3 4 3 3 2 6 1 
2 2 2 3 7 2 2 2 4 7 4 2 6 1 1 
3 7 1 1 1 1 2 2 7 5 7 7 1 1 1 
# Pieces
10 13 RED BASE 150
4 6 BLUE BASE 150
7 6 BLUE GENERATOR 100
7 13 RED GENERATOR 100
10 12 RED COLONIST 100
4 7 BLUE COLONIST 100
# Teams
RED 5
BLUE 5
# Upgrades
RED|
BLUE|
# Meta
Turn 1 
Phase ORDERS 
