1 1 1 6 4 2 2 2 7 7 3 3 2 5 5 
1 1 1 4 3 2 2 2 2 2 7 2 2 4 5 
1 1 1 2 2 2 2 3 2 2 2 2 3 2 4 
1 1 1 3 2 3 5 5 7 2 7 5 5 3 3 
1 1 1 6 3 5 5 5 5 2 5 5 5 5 3 
1 1 1 1 5 5 4 7 5 2 5 7 4 5 5 
1 1 1 6 5 5 7 4 2 2 2 4 7 5 5 
1 1 1 2 7 5 5 2 2 2 2 2 5 5 7 
1 1 1 3 4 2 4 2 2 3 2 2 4 2 4 
1 1 1 2 7 5 5 2 2 2 2 2 5 5 7 
1 1 1 6 5 5 7 4 2 2 2 4 7 5 5 
1 1 1 1 5 5 4 7 5 2 5 7 4 5 5 
1 1 1 6 3 5 5 5 5 2 5 5 5 5 3 
1 1 1 3 2 3 5 5 7 2 7 5 5 3 3 
1 1 1 2 2 2 2 3 2 2 2 2 3 2 4 
1 1 1 4 3 2 2 2 7 2 2 2 2 4 5 
1 1 1 6 4 2 2 3 3 7 7 2 2 5 5 
# Pieces
5 15 RED BASE 150
5 1 BLUE BASE 150
4 15 RED COLONIST 100
4 1 BLUE COLONIST 100
4 0 BLUE GENERATOR 100
3 1 BLUE GENERATOR 100
4 16 RED GENERATOR 100
3 15 RED GENERATOR 100
6 16 RED BARRACKS 100
6 0 BLUE BARRACKS 100
# Teams
RED 5
BLUE 5
# Upgrades
RED|
BLUE|
# Meta
Turn 1 
Phase START_TURN
