7 3 4 7 5 5 5 7 4 2 5 3 2 3 5 2 4 7 5 5 5 7 4 3 7 
7 4 3 4 7 5 7 4 2 2 3 2 2 2 3 2 2 4 7 5 7 4 3 4 7 
3 2 2 2 2 3 5 2 2 4 7 5 3 5 7 4 2 2 5 3 2 2 2 2 3 
2 2 2 2 2 2 2 2 3 7 5 5 5 5 5 7 3 2 2 2 2 2 2 2 2 
3 2 2 5 2 2 2 2 2 5 7 3 3 3 7 5 2 2 2 2 2 5 2 2 3 
4 3 7 5 7 3 3 2 2 7 2 2 2 2 2 7 2 2 3 3 7 5 7 3 4 
2 7 5 6 6 1 1 7 2 2 2 2 4 2 2 2 2 7 1 1 6 6 5 7 2 
6 6 1 1 1 1 1 6 6 1 3 2 2 2 3 1 6 6 1 1 1 1 1 6 6 
1 1 1 1 1 1 1 1 1 1 1 3 3 3 1 1 1 1 1 1 1 1 1 1 1 
1 1 1 1 1 1 1 1 1 1 1 1 1 1 1 1 1 1 1 1 1 1 1 1 1 
# Pieces
23 4 RED BASE 150
1 4 BLUE BASE 150
22 0 BLUE GENERATOR 100
23 1 BLUE GENERATOR 100
1 1 RED GENERATOR 100
2 0 RED GENERATOR 100
2 3 BLUE BARRACKS 100
22 3 RED BARRACKS 100
24 5 RED GENERATOR 100
0 5 BLUE GENERATOR 100
12 6 NONE GUARDIAN 100
10 5 NONE TOWER 50
14 5 NONE TOWER 50
12 7 NONE TOWER 50
# Teams
RED 5
BLUE 5
# Upgrades
RED|
BLUE|
# Meta
Turn 1 
Phase ORDERS 
