1 1 1 1 1 1 1 1 1 1 1 1 1 1 1 1 1 
1 7 2 2 1 1 6 2 1 1 6 1 1 1 6 3 1 
1 2 3 2 1 2 7 2 8 4 3 6 8 2 2 6 1 
1 2 2 7 8 2 3 6 1 6 4 1 1 2 2 6 1 
1 1 1 8 1 6 1 1 1 1 6 1 1 6 6 1 1 
1 4 3 4 1 2 3 6 1 3 2 6 1 4 3 1 1 
1 6 7 2 1 2 4 6 1 6 4 2 1 2 7 6 1 
1 1 3 4 1 6 2 3 1 6 3 2 1 4 3 4 1 
1 1 6 6 1 1 6 1 1 1 1 6 1 8 1 1 1 
1 6 2 2 1 1 4 6 1 6 3 2 8 7 2 2 1 
1 6 2 2 8 6 3 4 8 2 7 2 1 2 3 2 1 
1 3 6 1 1 1 6 1 1 2 6 1 1 2 2 7 1 
1 1 1 1 1 1 1 1 1 1 1 1 1 1 1 1 1 
# Pieces
14 2 BLUE BASE 150
2 10 RED BASE 150
3 9 RED TOWER 50
13 3 BLUE TOWER 50
3 3 RED COLONIST 100
13 9 BLUE COLONIST 100
2 2 RED COLONIST 100
14 10 BLUE COLONIST 100
# Teams
RED 5
BLUE 5
# Upgrades
RED|COLONIST_MINING 
BLUE|COLONIST_MINING 
# Meta
Turn 1 
Phase ORDERS 
