6 4 4 1 1 1 3 4 1 1 6 1 1 6 1 1 4 3 1 1 1 4 4 6 
4 2 2 4 6 1 2 1 1 4 2 6 6 2 4 1 1 2 1 6 4 2 2 4 
2 3 7 2 2 1 6 1 1 6 3 2 2 3 6 1 1 6 1 2 2 7 3 2 
6 2 3 3 2 1 1 1 1 6 4 3 3 4 6 1 1 1 1 2 3 3 2 6 
1 6 2 2 6 1 3 1 1 1 6 2 2 6 1 1 1 3 1 6 2 2 6 1 
1 1 1 1 1 1 6 2 4 6 1 6 6 1 6 4 2 6 1 1 1 1 1 1 
1 1 1 2 1 1 1 3 2 6 1 1 1 1 6 2 3 1 1 1 2 1 1 1 
1 1 1 2 4 6 1 6 6 1 1 1 1 1 1 6 6 1 6 4 2 1 1 1 
3 6 1 3 2 6 1 1 1 3 4 1 1 4 3 1 1 1 6 2 3 1 6 3 
4 6 1 1 1 1 1 1 6 4 6 1 1 6 4 6 1 1 1 1 1 1 6 4 
# Pieces
20 7 RED BASE 150
3 7 BLUE BASE 150
4 7 BLUE GENERATOR 100
19 7 RED GENERATOR 100
23 9 RED GENERATOR 100
0 9 BLUE GENERATOR 100
7 5 BLUE COLONIST 100
16 5 RED COLONIST 100
15 6 RED TROOPER 100
8 6 BLUE TROOPER 100
# Teams
RED 5
BLUE 5
# Upgrades
RED|COLONIST_TERRAFORMING 
BLUE|COLONIST_TERRAFORMING 
# Meta
Turn 1 
Phase ORDERS 
