1 6 6 6 3 7 7 3 2 4 3 4 7 1 1 
6 3 4 3 2 2 2 2 2 3 4 2 2 5 1 
3 4 2 2 2 2 4 3 2 2 2 2 2 7 5 
4 2 2 2 2 3 1 1 4 7 3 6 2 2 4 
1 4 2 7 3 1 1 1 5 5 5 3 2 2 3 
1 1 1 1 1 1 1 3 3 7 2 2 2 4 1 
1 1 1 1 1 7 4 2 2 3 2 4 2 1 1 
1 1 2 4 2 3 2 2 4 7 1 1 1 1 1 
1 4 2 2 2 7 3 3 1 1 1 1 1 1 1 
3 2 2 3 5 5 5 1 1 1 3 7 2 4 1 
4 2 2 6 3 7 4 1 1 3 2 2 2 2 4 
5 7 2 2 2 2 2 3 4 2 2 2 2 4 3 
1 5 2 2 4 3 2 2 2 2 2 3 4 3 6 
1 1 7 4 3 4 2 3 7 7 3 6 6 6 1
# Pieces
2 3 RED BASE 150
4 3 RED BARRACKS 100
12 10 BLUE BASE 150
10 10 BLUE BARRACKS 100
4 1 RED BARRACKS 100
10 12 BLUE BARRACKS 100
1 4 RED CARBON_GENERATOR 100
0 3 RED MINERAL_GENERATOR 100
1 2 RED GAS_GENERATOR 100
13 9 BLUE CARBON_GENERATOR 100
14 10 BLUE MINERAL_GENERATOR 100
13 11 BLUE GAS_GENERATOR 100
# Teams
RED 5 5 5
BLUE 5 5 5
# Upgrades
RED|
BLUE|
