1 1 1 1 1 1 1 1 1 1 1 1 1 1 1
1 1 2 3 2 2 2 2 2 2 3 4 2 4 1
1 2 2 3 2 3 1 2 2 4 2 2 2 4 1
1 4 4 2 2 1 1 1 2 2 7 2 2 4 1
1 2 2 2 2 1 1 1 2 4 7 4 2 2 1
1 4 2 2 4 1 1 3 2 2 2 2 2 4 1
1 4 2 2 2 2 2 3 3 2 1 1 2 1 1
1 1 4 4 2 2 2 2 2 2 1 1 2 2 1
1 1 1 1 7 4 7 3 2 2 2 2 4 4 1
1 1 1 1 1 1 1 1 1 1 1 1 1 1 1
# Pieces
2 6 RED BASE 100
1 5 RED CARBON_GENERATOR 100
1 6 RED MINERAL_GENERATOR 100
2 7 RED GAS_GENERATOR 100
12 2 BLUE BASE 100
13 1 BLUE CARBON_GENERATOR 100
13 2 BLUE MINERAL_GENERATOR 100
13 3 BLUE GAS_GENERATOR 100
# Teams
RED 5 5 5
BLUE 5 5 5
# Upgrades
RED|
BLUE|
