1 1 1 1 1 1 1 1 1 1 1 1 1 1 1 
1 1 2 3 2 2 6 2 2 2 3 4 2 4 1 
1 2 2 3 2 3 1 2 2 4 2 2 2 4 1 
1 4 4 2 2 1 1 1 2 2 7 2 2 2 1 
1 2 2 2 2 1 1 1 2 4 7 4 2 2 1 
1 4 2 2 4 1 1 3 2 2 2 2 2 4 1 
1 4 2 2 2 2 2 3 3 2 1 1 6 1 1 
1 1 4 2 2 2 2 2 2 2 1 1 2 2 1 
1 1 1 1 7 4 7 3 2 2 6 2 4 4 1 
1 1 1 1 1 1 1 1 1 1 1 1 1 1 1 
# Pieces
2 6 RED BASE 150
1 5 RED GENERATOR 100
1 6 RED GENERATOR 100
2 7 RED GENERATOR 100
12 2 BLUE BASE 150
13 1 BLUE GENERATOR 100
13 2 BLUE GENERATOR 100
3 7 RED BARRACKS 100
13 3 BLUE BARRACKS 100
11 1 BLUE GENERATOR 100
# Teams
RED 5
BLUE 5
# Upgrades
RED|
BLUE|
# Meta
Turn 1
Phase ORDERS
