1 1 1 1 1 1 1 1 1 1 1 1 1 1 1
1 1 7 4 6 1 1 1 1 2 4 1 1 1 1
1 1 4 2 4 6 1 1 6 2 2 4 1 1 1
1 1 6 4 2 4 6 1 2 2 2 2 1 1 1
1 1 1 6 4 2 6 1 6 2 2 2 7 1 1
1 1 1 1 6 6 2 6 1 2 2 2 2 5 1
1 1 1 1 1 1 6 4 1 7 2 2 2 4 1
1 1 1 6 2 6 1 1 1 5 2 2 2 3 1
1 1 2 2 2 2 2 7 5 3 3 2 7 4 1
1 1 4 2 2 2 2 2 2 3 2 3 1 1 1
1 1 1 4 2 2 2 2 2 2 3 3 6 1 1
1 1 1 1 1 7 2 2 2 7 1 6 4 1 1
1 1 1 1 1 1 5 4 3 4 1 1 1 1 1
1 1 1 1 1 1 1 1 1 1 1 1 1 1 1
# Pieces
2 8 RED BASE 150
9 1 BLUE BASE 150
4 8 RED BARRACKS 100
9 3 BLUE BARRACKS 100
10 2 BLUE COLONIST 100
3 9 RED COLONIST 100
# Teams
RED 5
BLUE 5
# Upgrades
RED|
BLUE|
