5 5 7 2 3 1 3 4 2 2 2 3 2 3 2 2 3 2 2 2 3 4 
4 7 4 2 1 1 4 3 3 4 1 1 6 6 1 3 3 3 2 3 2 7 
2 4 2 2 1 7 2 2 4 1 1 1 2 2 1 1 1 1 1 4 7 4 
3 2 1 1 1 7 2 2 2 1 1 1 3 2 2 7 2 4 1 1 1 1 
3 3 6 2 3 3 2 2 2 1 1 1 1 3 2 2 3 2 2 6 3 7 
7 3 6 2 2 3 2 2 3 1 1 1 1 2 2 3 3 2 2 6 3 3 
1 1 1 1 4 2 7 2 2 3 1 1 1 2 2 2 7 1 1 1 2 3 
4 7 4 1 1 1 1 1 2 2 1 1 1 4 2 2 7 1 2 2 4 2 
7 2 3 2 3 3 3 1 6 6 1 1 4 3 3 4 1 1 2 4 7 4 
4 3 2 2 2 3 2 2 3 2 3 2 2 2 4 3 1 3 2 7 5 5 
# Pieces
1 8 RED BASE 150
20 1 BLUE BASE 150
21 2 BLUE GENERATOR 100
21 0 BLUE GENERATOR 100
19 2 BLUE GENERATOR 100
0 9 RED GENERATOR 100
0 7 RED GENERATOR 100
2 7 RED GENERATOR 100
3 8 RED BARRACKS 100
18 1 BLUE BARRACKS 100
19 0 BLUE COLONIST 100
2 9 RED COLONIST 100
# Teams
RED 5
BLUE 5
# Upgrades
RED|
BLUE|
# Meta
Turn 1 
Phase ORDERS 
