1 1 1 1 1 1 1 1 1 1 1 1 1 1 1 1 1 
1 1 1 1 1 1 1 1 1 1 1 1 1 1 1 1 1 
1 1 1 1 1 6 6 1 1 1 6 6 1 1 1 1 1 
1 1 1 7 4 2 3 6 1 6 3 2 4 7 1 1 1 
1 6 7 2 3 4 7 6 1 6 7 4 3 2 7 6 1 
1 6 2 3 2 6 6 1 1 1 6 6 2 3 2 6 1 
1 7 2 2 6 1 1 1 1 1 1 1 6 2 2 7 1 
1 2 3 4 6 1 1 1 1 1 1 1 6 4 3 2 1 
1 5 2 2 6 1 1 1 1 1 1 1 6 2 2 5 1 
1 5 2 2 3 6 1 1 1 1 1 6 3 2 2 5 1 
1 1 3 3 2 6 4 6 4 6 4 6 2 3 3 1 1 
1 1 7 2 2 2 4 6 4 6 4 2 2 2 7 1 1 
1 1 6 4 7 2 2 2 2 2 2 2 7 4 6 1 1 
1 1 6 7 3 3 2 3 7 3 2 3 3 7 6 1 1 
1 1 1 6 2 3 2 7 5 7 2 3 2 6 1 1 1 
1 1 1 1 6 3 4 7 5 7 4 3 6 1 1 1 1 
1 1 1 1 1 6 6 1 1 1 6 6 1 1 1 1 1 
1 1 1 1 1 1 1 1 1 1 1 1 1 1 1 1 1 
# Pieces
3 4 BLUE BASE 150
13 4 RED BASE 150
6 10 NONE GENERATOR 100
6 11 NONE GENERATOR 100
8 11 NONE GENERATOR 100
10 11 NONE GENERATOR 100
10 10 NONE GENERATOR 100
14 5 RED BARRACKS 100
2 5 BLUE BARRACKS 100
4 3 BLUE GENERATOR 100
5 4 BLUE GENERATOR 100
11 4 RED GENERATOR 100
12 3 RED GENERATOR 100
8 10 NONE GENERATOR 100
8 12 NONE TECHLAB 50
6 12 NONE TECHLAB 50
10 12 NONE TECHLAB 50
# Teams
RED 5
BLUE 5
# Upgrades
RED|
BLUE|
# Meta
Turn 1 
Phase START_TURN
