5 5 5 5 5 5 5 5 5 5 5 5 5 5 5 5 5 5 5 5 
5 5 4 7 5 4 5 7 5 4 4 5 7 5 4 5 7 4 5 5 
5 4 5 5 5 7 5 4 5 5 5 5 4 5 7 5 5 5 4 5 
5 7 5 7 4 5 5 5 7 2 2 7 5 5 5 4 7 5 7 5 
2 2 2 2 2 7 2 3 2 2 2 2 3 2 7 2 2 2 2 2 
7 2 3 2 2 2 2 2 2 2 2 2 2 2 2 2 2 3 2 7 
5 7 2 2 7 3 2 7 2 2 2 2 7 2 3 7 2 2 7 5 
5 7 5 5 5 5 5 5 7 2 2 7 5 5 5 5 5 5 7 5 
4 5 7 2 7 7 5 4 5 5 5 5 4 5 7 7 2 7 5 4 
5 7 2 2 2 3 7 5 5 5 5 5 5 7 3 2 2 2 7 5 
5 7 4 2 2 4 7 5 7 5 5 7 5 7 4 2 2 4 7 5 
4 5 7 4 4 7 5 4 5 5 5 5 4 5 7 4 4 7 5 4 
# Pieces
16 10 RED COLONIST 100
3 10 BLUE COLONIST 100
2 9 BLUE COLONIST 100
17 9 RED COLONIST 100
15 9 RED BASE 150
4 10 BLUE BASE 150
# Teams
RED 5
BLUE 5
# Upgrades
RED|COLONIST_TERRAFORMING 
BLUE|COLONIST_TERRAFORMING 
# Meta
Turn 1 
Phase ORDERS 
