5 7 7 4 7 7 2 2 3 2 2 3 7 5 5 
7 7 4 2 7 3 2 2 7 2 2 5 4 4 5 
7 2 2 5 3 2 2 7 2 2 4 5 7 2 2 
3 2 2 5 2 2 3 7 4 2 7 3 2 2 3 
4 2 2 2 2 2 5 5 5 2 2 2 2 2 4 
4 2 2 2 2 2 5 5 5 2 2 2 2 2 4 
3 2 2 3 7 2 4 7 3 2 2 5 2 2 3 
2 2 7 5 4 2 2 7 2 2 3 5 2 2 7 
5 4 4 5 2 2 7 2 2 3 7 2 4 7 7 
5 5 7 3 2 2 3 2 2 7 7 4 7 7 5 
# Pieces
13 4 RED BASE 150
1 5 BLUE BASE 150
1 4 BLUE BARRACKS 100
13 5 RED BARRACKS 100
14 4 RED GENERATOR 100
14 5 RED GENERATOR 100
0 4 BLUE GENERATOR 100
0 5 BLUE GENERATOR 100
# Teams
RED 5
BLUE 5
# Upgrades
RED|
BLUE|
# Meta
Turn 1 
Phase START_TURN
