5 7 5 5 3 5 5 5 5 7 1 1 1 7 5 5 5 5 3 5 5 7 5 
5 5 5 5 2 7 4 5 5 5 1 1 1 5 5 5 4 7 2 5 5 5 5 
5 5 7 2 2 4 2 4 7 5 1 1 1 5 7 4 2 4 2 2 7 5 5 
5 3 2 2 2 2 2 2 3 2 1 1 1 2 3 2 2 2 2 2 2 3 5 
7 2 3 2 2 2 5 7 3 2 1 1 1 2 3 7 5 2 2 2 3 2 7 
2 3 3 3 5 3 3 5 2 1 1 1 1 1 2 5 3 3 5 3 3 3 2 
2 2 3 5 5 3 2 2 2 1 6 2 6 1 2 2 2 3 5 5 3 2 2 
2 2 5 5 5 2 2 2 4 1 3 3 3 1 4 2 2 2 5 5 5 2 2 
2 2 7 5 7 2 2 2 1 1 4 5 4 1 1 2 2 2 7 5 7 2 2 
2 2 2 2 2 2 3 2 1 3 3 5 3 3 1 2 3 2 2 2 2 2 2 
4 3 4 2 2 2 2 2 1 1 7 5 7 1 1 2 2 2 2 2 4 3 4 
3 4 2 2 5 2 2 2 4 1 6 4 6 1 4 2 2 2 5 2 2 4 3 
2 3 3 5 5 3 2 2 1 1 1 7 1 1 1 2 2 3 5 5 3 3 2 
2 3 7 5 7 3 3 2 6 4 6 6 6 4 6 2 3 3 7 5 7 3 2 
2 3 5 5 4 3 4 1 6 3 6 1 6 3 6 1 4 3 4 5 5 3 2 
2 2 7 5 3 2 2 6 3 4 1 1 1 4 3 6 2 2 3 5 7 2 2 
2 2 2 2 2 2 2 6 2 1 6 1 6 1 2 6 2 2 2 2 2 2 2 
3 2 2 3 2 2 1 1 3 6 4 6 4 6 3 1 1 2 2 3 2 2 3 
7 4 3 4 3 2 6 3 4 6 3 6 3 6 4 3 6 2 3 4 3 4 7 
5 7 4 7 7 3 6 7 7 1 7 1 7 1 7 7 6 3 7 7 4 7 5 
# Pieces
4 3 RED BASE 150
18 3 BLUE BASE 150
17 2 BLUE GENERATOR 100
16 1 BLUE GENERATOR 100
15 2 BLUE GENERATOR 100
7 2 RED GENERATOR 100
6 1 RED GENERATOR 100
5 2 RED GENERATOR 100
2 3 RED BARRACKS 100
3 4 RED BARRACKS 100
19 4 BLUE BARRACKS 100
20 3 BLUE BARRACKS 100
# Teams
RED 5
BLUE 5
# Upgrades
RED|
BLUE|
# Meta
Turn 1 
Phase START_TURN
