1 1 1 1 1 1 1 1 6 1 1 1 1 1 1 1 1 
1 1 1 1 1 1 1 1 4 1 1 1 1 1 1 1 1 
1 1 1 1 1 1 1 6 4 6 1 1 1 1 1 1 1 
1 1 1 1 3 6 6 4 2 4 6 6 3 1 1 1 1 
1 1 1 1 7 1 1 7 4 7 1 1 7 1 1 1 1 
1 1 1 1 6 6 5 7 4 7 5 6 6 1 1 1 1 
1 1 1 1 1 6 2 2 3 2 2 6 1 1 1 1 1 
1 1 1 1 6 4 7 2 2 2 7 4 6 1 1 1 1 
1 1 2 6 6 2 3 3 7 3 3 2 6 6 2 1 1 
1 1 6 1 7 2 2 2 5 2 2 2 7 1 6 1 1 
1 1 6 3 2 2 2 2 5 2 2 2 2 3 6 1 1 
6 2 2 2 3 3 4 5 7 5 4 3 3 2 2 2 6 
4 2 2 3 2 7 5 5 5 5 5 7 2 3 2 2 4 
4 3 3 4 5 5 5 7 5 7 5 5 5 4 3 3 4 
# Pieces
14 12 BLUE BASE 150
2 12 RED BASE 150
2 11 RED BARRACKS 100
14 11 BLUE BARRACKS 100
0 12 RED GENERATOR 100
0 13 RED GENERATOR 100
3 13 RED GENERATOR 100
13 13 BLUE GENERATOR 100
16 13 BLUE GENERATOR 100
16 12 BLUE GENERATOR 100
# Teams
RED 5
BLUE 5
# Upgrades
RED|
BLUE|
# Meta
Turn 1 
Phase ORDERS 
