2 3 2 2 3 2 2 2 2 2 2 2 1 1 1
2 2 2 2 2 2 3 2 2 3 3 3 1 1 1
2 2 3 2 1 2 2 2 2 2 2 1 1 1 2
2 2 2 2 1 1 1 1 3 3 1 1 1 2 2
2 3 2 1 1 1 2 1 3 3 1 1 1 2 2
2 2 2 1 1 2 2 2 2 3 3 3 1 1 2
2 2 2 2 2 1 2 2 2 2 2 2 2 1 1
2 3 3 2 2 2 2 2 2 2 1 2 2 2 2
2 3 2 2 1 1 2 3 2 2 2 3 2 3 1
2 2 1 1 1 1 1 2 3 2 2 2 1 1 1
# Units
1 1 RED COLONIST
2 1 RED TROOPER
3 1 RED RANGER
1 6 RED TROOPER
9 8 RED GHOST
8 8 BLUE COLONIST
7 8 BLUE TROOPER
6 8 BLUE RANGER
1 7 BLUE TROOPER
4 1 BLUE GHOST
# Buildings
# Teams
RED
BLUE
