2 3 2 2 3 2 2 2 2 2 2 2 1 1 1 1 1 1 1 1 1 1 1 1 1
2 2 2 2 2 2 3 2 2 3 3 3 1 1 1 1 1 1 1 1 1 1 1 1 1
2 2 3 2 1 2 2 2 2 2 2 1 1 1 2 2 1 1 1 1 1 1 1 1 1
2 2 2 2 1 1 1 1 3 3 1 1 1 2 3 2 1 2 1 1 1 1 1 1 1
2 3 2 1 1 1 2 1 3 3 1 1 1 2 2 1 1 1 1 1 1 1 1 1 1
2 2 2 1 1 2 2 2 2 3 3 3 1 1 2 2 1 1 1 1 1 2 1 1 1
2 2 2 2 2 1 2 2 2 2 2 2 2 1 1 1 1 1 1 1 2 2 2 1 1
2 3 3 2 2 2 2 2 2 2 1 2 2 2 2 1 1 1 1 1 2 2 3 3 1
2 3 2 2 1 1 2 3 2 2 2 3 2 3 1 1 1 1 1 1 1 2 2 2 1
2 2 1 1 1 1 1 2 3 2 2 2 1 1 1 1 1 1 1 1 1 1 2 2 1
2 1 1 1 1 1 2 2 2 2 3 2 2 1 1 1 1 1 1 1 1 1 2 1 1
1 1 1 1 1 1 1 1 1 2 2 2 3 3 1 1 1 1 1 1 1 1 2 1 1
1 1 1 1 1 1 1 1 1 1 1 1 2 2 1 1 1 2 1 1 1 1 1 1 1
1 1 1 1 1 1 1 1 1 1 1 1 1 1 1 1 1 2 1 1 1 1 2 1 1
1 1 1 1 1 1 1 1 1 1 1 1 1 1 1 1 3 2 1 1 1 1 1 1 1
2 2 1 1 1 1 1 1 1 1 1 1 1 1 1 2 2 1 1 1 1 1 1 1 1
3 2 3 3 1 1 1 1 1 1 1 1 1 1 1 1 2 1 2 2 1 1 1 1 1
2 3 2 3 2 1 1 1 1 1 1 1 1 1 1 1 1 1 2 1 2 1 1 1 1
2 2 3 3 2 2 1 1 1 1 1 1 1 1 1 1 1 1 1 1 1 1 1 1 1
2 3 3 3 2 1 1 1 1 1 1 1 1 1 1 1 1 1 1 1 1 1 1 1 1
1 1 1 1 1 1 1 1 1 1 1 1 1 1 1 1 1 1 1 1 1 1 1 1 1
# Units
1 1 RED Colonist
2 1 RED Trooper
3 1 RED Ranger
1 6 RED Trooper
9 8 RED Ghost

8 8 BLUE Colonist
7 8 BLUE Trooper
6 8 BLUE Ranger
1 7 BLUE Trooper
4 1 BLUE Ghost
# Buildings
0 0 RED Base
9 9 BLUE Base
# Teams
RED
BLUE
