1 1 1 1 1 1 1 1 1 1 1 1 1 1 1 
1 1 4 2 4 1 1 1 1 1 1 1 1 1 1 
1 4 3 2 2 2 1 1 1 3 2 4 1 1 1 
1 2 3 2 2 3 2 2 2 2 3 2 4 1 1 
1 4 2 2 2 2 2 2 2 2 2 2 2 1 1 
1 1 2 2 3 3 2 1 1 4 2 2 3 1 1 
1 1 1 2 3 1 1 1 1 1 2 3 1 1 1 
1 1 1 3 2 1 1 1 1 1 3 2 1 1 1 
1 1 3 2 2 4 1 1 2 3 3 2 2 1 1 
1 1 2 2 2 2 2 2 2 2 2 2 2 4 1 
1 1 4 2 3 2 2 2 2 3 2 2 3 2 1 
1 1 1 4 2 3 1 1 1 2 2 2 3 4 1 
1 1 1 1 1 1 1 1 1 1 4 2 4 1 1 
1 1 1 1 1 1 1 1 1 1 1 1 1 1 1 
1 1 1 1 1 1 1 1 1 1 1 1 1 1 1 
# Units
# Buildings
3 3 RED BASE
4 4 RED BARRACKS
11 10 BLUE BASE
10 9 BLUE BARRACKS
# Teams
RED
BLUE